w,w,w,w,w,l,l,w,w,w,w,w,w,w,w,w
w,l,w,w,w,l,l,w,w,w,w,w,l,l,l,w
w,l,l,w,w,l,w,w,l,l,w,w,w,l,w,w
w,w,w,w,w,w,w,w,l,w,w,l,w,w,w,w
w,w,w,l,w,w,l,w,w,w,l,l,w,w,w,w
w,w,w,l,l,w,w,w,w,w,w,l,w,w,l,w
w,w,w,w,l,l,w,w,l,w,w,w,w,l,l,w
w,w,w,w,w,w,w,l,l,l,w,w,w,w,w,w
w,w,l,w,w,w,w,w,w,l,l,w,w,w,w,w
w,w,l,w,w,w,w,w,w,l,w,w,w,l,w,w
w,w,w,w,w,l,w,l,w,w,w,w,l,l,w,w
w,w,w,l,w,w,w,w,w,w,w,l,l,l,w,w
w,l,w,w,w,w,l,w,w,w,w,l,l,l,w,w
w,w,w,l,w,w,w,w,w,w,w,l,l,w,w,w
w,w,w,w,w,l,w,l,w,w,w,w,w,w,w,w
w,w,w,w,w,w,w,w,w,w,w,w,w,w,w,w